1111111111111111
100C00E00000C001
111C000000P0C001
1C100C00C00CC001
1110011111100001
1000010C00100001
1110010000111101
1010C11000C00C01
1010111110001101
100001C010001001
1110010C11101001
101001C000101111
101C0C00C0100C01
101C11001110C001
10C00111100C00C1
1111111111111111