1111111111111111
100000E00111C001
10CC000001P1C001
1C000C00C111C001
10C0011111100001
1000010C00100001
1110010000111101
1010C11000C00C01
1010111110001101
100001C010001001
1110010C11101001
101001C000101111
101C0C00C0100C01
101C11001110C001
10C00111100C00C1
1111111111111111