11111111111111111111
100000000E0000000001
1000C000000C0000C001
100000000C0000000001
100000000C0000C00001
1000C0000000C000C001
100000000P000C000001
11111111111111111111