1111111111111111111111111111111111
1C1C0001C00C0C0C010C0010C0010C0001
1C0C0101111110C10100C0111C110C0011
101111010A001C01010000001C10C01001
1C000101000011C0011101100010C11001
101111000100C00C01000100001111C001
1C1000010111111111000100100010C011
101110010CC000C00100010110001C1001
1C1000C111111C110110110100111C1001
101010000P000001001010010010C01111
1C1111110C01C00100101011E01000C001
100A00011111010100001001111111C101
100C0C0100010101011111111000000001
11111C01100101011100C0C000010C10C1
10C000C0000C0100C00110C01C01C01C01
1111111111111111111111111111111111