11111111111
1ECP0000001
11111011111